# Formables
ATL = "countries/Atlantis.txt"

# Atlantis
AEA = "countries/Aeacusa.txt"		# Hellenic, High Atlantean, Monarchy
AKY = "countries/Askloy.txt"		# Hellenic, Islander Atlantean, Monarchy
AMP = "countries/Ampheres.txt"      # Hellenic, High Atlantean, Monarchy
ANA = "countries/Anatolikos.txt"    # Hellenic, High Atlantean, Republic
ANX = "countries/Anaxophas.txt"     # Hellenic, South Atlantean, Monarchy
APF = "countries/Anthropofagoi.txt" # Hellenic, South Atlantean, Monarchy
APO = "countries/Apoak.txt"			# Hellenic, High Atlantean, Monarchy
ASO = "countries/Asaero.txt"		# Hellenic, South Atlantean, Monarchy
ATE = "countries/Aterpea.txt"       # Hellenic, Islander Atlantean, Republic
ATZ = "countries/Artzainoi.txt"     # Hellenic, South Atlantean, Monarchy
AUT = "countries/Autochthon.txt"    # Hellenic, South Atlantean, Monarchy
AZA = "countries/Azaes.txt"         # Hellenic, High Atlantean, Monarchy
BNP	= "countries/Banepstimyo.txt"   # Hellenic, South Atlantean, Monarchy
CRC = "countries/Crecreyo.txt"		# Hellenic, South Atlantean, Monarchy
CYS = "countries/Chrysoses.txt"     # Hellenic, High Atlantean, Monarchy
CYV = "countries/Chamylav.txt"		# Hellenic, South Atlantean, Monarchy
DAG = "countries/Dautherag.txt"		# Hellenic, High Atlantean, Monarchy
DAP = "countries/Daephi.txt"		# Hellenic, South Atlantean, Monarchy
DEL = "countries/Delcenthon.txt"	# Hellenic, South Atlantean, Monarchy
DIA = "countries/Diaprepes.txt"     # Hellenic, High Atlantean, Monarchy
DOR = "countries/Doroncen.txt"		# Hellenic, High Atlantean, Monarchy
EDK = "countries/Erreduro.txt"		# Hellenic, Mountain Atlantean, Monarchy
ELA = "countries/Elasippus.txt"     # Hellenic, Islander Atlantean, Monarchy
EVA = "countries/Evaemon.txt"       # Hellenic, South Atlantean, Monarchy
HER = "countries/Hermusa.txt"       # Hellenic, North Atlantean, Monarchy
HNO = "countries/Heraneko.txt"		# Hellenic, High Atlantean, Monarchy
HYE = "countries/Hyblilene.txt"		# Hellenic, South Atlantean, Monarchy
ICH	= "countries/Ichthyofagoi.txt"  # Hellenic, Islander Atlantean, Monarchy
IND = "countries/Indarra.txt"       # Hellenic, North Atlantean, Monarchy
ION = "countries/Ionmym.txt"		# Hellenic, High Atlantean, Monarchy
KNV = "countries/Kanivalon.txt"     # Hellenic, North Atlantean, Monarchy
KUW = "countries/Kuwaoek.txt"	    # Hellenic, South Atlantean, Monarchy
KOA = "countries/Katoikia.txt"		# Hellenic, Mountain Atlantean, Monarchy	
MEL = "countries/Melachrinoi.txt"   # Hellenic, North Atlantean, Monarchy
MES = "countries/Mestor.txt"        # Hellenic, Islander Atlantean, Monarchy
MNE = "countries/Mneseus.txt"       # Hellenic, South Atlantean, Monarchy
MPS = "countries/Meropis.txt"		# Hellenic, Meropisean, Monarchy
MRR = "countries/Maraath.txt"		# Hellenic, Islander Atlantean, Monarchy
OIN = "countries/Oinordekoek.txt"   # Hellenic, North Atlantean, Monarchy
PHI = "countries/Philippia.txt"		# Hellenic, Islander Atlantean, Monarchy
PSM = "countries/Polisrusm.txt"		# Hellenic, South Atlantean, Monarchy
SAG = "countries/Sagarro.txt"		# Hellenic, North Atlantean, Monarchy
SOR	= "countries/Sorginak.txt"      # Hellenic, South Atlantean, Monarchy
RAK = "countries/Rakkad.txt"		# Hellenic, High Atlantean, Monarchy
TAD = "countries/Tadipouro.txt"		# Hellenic, North Atlantean, Monarchy
TCH = "countries/Trichotos.txt"     # Hellenic, South Atlantean, Monarchy
THO = "countries/Thonrodo.txt"		# Hellenic, High Atlantean, Monarchy
TYA = "countries/Tauryria.txt"		# Hellenic, Islander Atlantean, Monarchy
VOR = "countries/Vorenus.txt"       # Hellenic, South Atlantean, Monarchy
VOU = "countries/Vounospiti.txt"	# Hellenic, Mountain Atlantean, Monarchy
YLK = "countries/Yamylaik.txt" 	    # Hellenic, High Atlantean, Monarchy

#Thule
THL = "countries/Thule.txt" 		# Catholic, Irish, Monarchy

#Lemuria
LNK = "countries/Lankr.txt"         # Asakti, Lemurian, Monarchy
PNA = "countries/Pantiya.txt"       # Asakti, Lemurian, Monarchy
SDP = "countries/Sudopalis.txt"     # Asakti, Lemurian, tribal_kingdom
STO = "countries/Stolat.txt"        # Asakti, Lemurian, Monarchy
VNG = "countries/Vangvangdaq.txt"   # Asakti, Lemurian, Monarchy
YUB = "countries/Yubervalt.txt"     # Asakti, Lemurian, Monarchy
ZLO = "countries/Zlobenea.txt"      # Asakti, Lemurian, Monarchy

00L = "countries/Khobiya.txt"  # Zoroastrian, Gujarati, Monarchy
01L = "countries/Sivava.txt"  # Zoroastrian, Tamil, Monarchy
02L = "countries/Antitha.txt"  # Zoroastrian, Tamil, Monarchy
03L = "countries/Payamgi.txt"  # Zoroastrian, Gujarati, Monarchy
04L = "countries/Gutta.txt"  # Zoroastrian, Gujarati, Monarchy
05L = "countries/Joyangi.txt"  # Zoroastrian, Gujarati, Monarchy
06L = "countries/Navdarik.txt"  # Animism, Gujarati, Monarchy 
07L = "countries/Malirva.txt"  # Asakti, Tamil, Monarchy 